1111111
1110001
1112401
1003001
1004301
1100101
1111111
