1111111
1214001
1000011
1000001
1030101
1000001
1111111
