1111111
1100001
1000141
1004301
1110301
1120011
1111111
