1111111
1010101
1000001
1100011
1033101
1002441
1111111
