1111111
1000411
1100341
1403011
1033021
1410011
1111111
